0 30 90 100 60 115 180 150 235 255 300 340 350 185 190 200 195 220 270 275 280 300 450 500 600 800 900 1000 1300 1400
30 0 60 80 65 130 200 190 240 260 300 320 340 185 190 195 210 230 260 270 300 350 420 470 570 770 870 970 1270 1370
90 30 0 20 85 170 165 125 150 160 230 260 275 290 295 310 330 350 370 300 280 300 350 340 360 700 800 900 1200 1300
100 90 30 0 95 180 175 135 160 170 240 270 285 300 305 320 340 360 380 310 290 310 360 350 370 710 810 910 1210 1310
60 100 90 30 0 85 150 120 205 225 270 310 320 155 160 170 165 190 240 245 245 270 420 470 570 770 870 970 1270 1370
115 60 100 90 30 0 180 150 235 255 300 340 350 185 190 200 195 220 270 275 275 300 450 500 600 800 900 1000 1300 1400
180 115 60 100 90 30 0 180 265 285 330 370 380 215 120 230 225 215 300 305 305 330 480 530 630 830 930 1030 1360 1460
150 180 115 60 100 90 30 0 285 305 350 390 400 235 240 255 145 270 320 225 325 350 500 550 650 850 950 1050 1350 1450
235 150 180 115 60 100 90 30 0 325 370 410 420 255 260 275 165 290 340 245 345 370 520 570 670 870 970 1070 1370 1470
255 235 150 180 115 60 100 90 30 0 390 430 440 275 280 295 185 310 360 265 365 390 540 590 690 890 990 1090 1390 1490
300 255 235 150 180 115 60 100 90 30 0 450 460 295 300 315 205 330 380 285 385 410 560 610 710 910 1010 1100 1410 1510
340 300 255 235 150 180 115 60 100 90 30 0 480 315 320 335 225 350 400 305 405 430 580 630 730 930 1030 1120 1430 1590
350 340 300 255 235 150 180 115 60 100 90 30 0 335 340 355 245 370 420 325 425 450 600 650 750 950 1050 1140 1450 1610
185 350 340 300 255 235 150 180 115 60 100 90 30 0 360 365 265 390 440 345 445 470 620 670 760 970 7070 1160 1470 1630
190 185 350 340 300 255 235 150 180 115 60 100 90 30 0 385 285 410 460 365 465 490 640 690 780 990 1090 1180 1490 1650
200 190 185 350 340 300 255 235 150 180 115 60 100 90 30 0 305 430 480 385 485 510 660 710 800 1010 1110 1200 1510 1670
195 200 190 185 350 340 300 255 235 150 180 115 60 100 90 30 0 450 500 405 505 530 680 730 820 1030 1130 1220 1530 1690
220 195 200 190 185 350 340 300 255 235 150 180 115 60 100 90 30 0 520 425 525 550 700 750 840 1050 1150 1240 1550 1710
270 220 195 200 190 185 350 340 300 255 235 150 180 115 60 100 90 30 0 445 545 570 720 770 860 1070 1170 1260 1570 1730
275 270 220 195 200 190 185 350 340 300 255 235 150 180 115 60 100 90 30 0 565 590 740 790 880 1090 1190 1280 1590 1750
280 275 270 220 195 200 190 185 350 340 300 255 235 150 180 115 60 100 90 30 0 610 760 810 900 1110 1210 1300 1610 1770
300 280 275 270 220 195 200 190 185 350 340 300 255 235 150 180 115 60 100 90 30 0 780 830 920 1130 1230 1320 1630 1790
450 300 280 275 270 220 195 200 190 185 350 340 300 255 235 150 180 115 60 100 90 30 0 850 940 1150 1250 1340 1650 1810
500 450 300 280 275 270 220 195 200 190 185 350 340 300 255 235 150 180 115 60 100 90 30 0 960 1170 1270 1360 1670 1830
600 500 450 300 280 275 270 220 195 200 190 185 350 340 300 255 235 150 180 115 60 100 90 30 0 1190 1290 1380 1690 1850
800 600 500 450 300 280 275 270 220 195 200 190 185 350 340 300 255 235 150 180 115 60 100 90 30 0 1310 1400 1710 1870
900 800 600 500 450 300 280 275 270 220 195 200 190 185 350 340 300 255 235 150 180 115 60 100 90 30 0 1420 1730 1890
1000 900 800 600 500 450 300 280 275 270 220 195 200 190 185 350 340 300 255 235 150 180 115 60 100 90 30 0 1750 1910
1300 1000 900 800 600 500 450 300 280 275 270 22 0 195 200 190 185 350 340 300 255 235 150 180 115 60 100 90 30 0 1930
1400 1300 1000 900 800 600 500 450 300 280 275 270 2000 195 200 190 185 350 340 300 255 235 150 180 115 60 100 90 30 0